0 1 1
	1 1
0 2 1
	1 11
0 3 2
	0.734341 111
	0.265659 101
0 4 2
	0.734341 1111
	0.265659 1011
0 5 2
	0.734341 11111
	0.265659 10111
1 2 1
	1 1
1 3 2
	0.734341 11
	0.265659 01
1 4 2
	0.734341 111
	0.265659 011
1 5 2
	0.734341 1111
	0.265659 0111
1 6 2
	0.734341 11111
	0.265659 01111
2 3 1
	1 1
2 4 1
	1 11
2 5 1
	1 111
2 6 1
	1 1111
2 7 1
	1 11111
3 4 1
	1 1
3 5 1
	1 11
3 6 1
	1 111
3 7 1
	1 1111
3 8 1
	1 11111
4 5 1
	1 1
4 6 1
	1 11
4 7 1
	1 111
4 8 1
	1 1111
4 9 1
	1 11111
5 6 1
	1 1
5 7 1
	1 11
5 8 1
	1 111
5 9 1
	1 1111
5 10 1
	1 11111
6 7 1
	1 1
6 8 1
	1 11
6 9 1
	1 111
6 10 1
	1 1111
6 11 1
	1 11111
7 8 1
	1 1
7 9 1
	1 11
7 10 1
	1 111
7 11 1
	1 1111
7 12 1
	1 11111
8 9 1
	1 1
8 10 1
	1 11
8 11 1
	1 111
8 12 1
	1 1111
8 13 1
	1 11111
9 10 1
	1 1
9 11 1
	1 11
9 12 1
	1 111
9 13 1
	1 1111
9 14 1
	1 11111
10 11 1
	1 1
10 12 1
	1 11
10 13 1
	1 111
10 14 1
	1 1111
10 15 1
	1 11111
11 12 1
	1 1
11 13 1
	1 11
11 14 1
	1 111
11 15 1
	1 1111
11 16 1
	1 11111
12 13 1
	1 1
12 14 1
	1 11
12 15 1
	1 111
12 16 1
	1 1111
12 17 1
	1 11111
13 14 1
	1 1
13 15 1
	1 11
13 16 1
	1 111
13 17 1
	1 1111
13 18 1
	1 11111
14 15 1
	1 1
14 16 1
	1 11
14 17 1
	1 111
14 18 1
	1 1111
14 19 1
	1 11111
15 16 1
	1 1
15 17 1
	1 11
15 18 1
	1 111
15 19 1
	1 1111
15 20 1
	1 11111
16 17 1
	1 1
16 18 1
	1 11
16 19 1
	1 111
16 20 1
	1 1111
16 21 1
	1 11111
17 18 1
	1 1
17 19 1
	1 11
17 20 1
	1 111
17 21 1
	1 1111
17 22 1
	1 11111
18 19 1
	1 1
18 20 1
	1 11
18 21 1
	1 111
18 22 1
	1 1111
19 20 1
	1 1
19 21 1
	1 11
19 22 1
	1 111
20 21 1
	1 1
20 22 1
	1 11
21 22 1
	1 1
